11111111111
1C0000000E1
10M00000M01
10000000001
10M00000M01
1C0000000P1
11111111111