1111111111
1000000001
10C0000E01
10C0000001
10C0000001
100000P001
1000000001
1111111111