1111111
11110E1
1110011
11C0111
1001111
1P11111
1111111