1111111111111
1C11000000C01
1100011111001
10P0110E00001
1111111111111