1111111111111
1C11000000C01
1100011111011
10P01100001E1
1111111111111