1111111111111
10P1000C00001
1000011111001
1P00110E00001
1111111111111