1111111111

1000000001

100PCE0001

1111111111