1111111111111
1C010000C01
1000011100001
10P0110E0001
1111111111111