1111111111111
1C01000000C01
1000011100001
10P0110E00001
1111111111111